{
    "서울": 0,
    "서울 종로구": 1,
    "서울 중구": 5,
    "서울 용산구": 1,
    "서울 성동구": 2,
    "서울 광진구": 3,
    "서울 동대문구": 4,
    "서울 중랑구": 1,
    "서울 성북구": 0,
    "서울 강북구": 1,
    "서울 도봉구": 1,
    "서울 노원구": 1,
    "서울 은평구": 0,
    "서울 서대문구": 1,
    "서울 마포구": 0,
    "서울 양천구": 6,
    "서울 강서구": 1,
    "서울 구로구": 4,
    "서울 금천구": 3,
    "서울 영등포구": 2,
    "서울 동작구": 0,
    "서울 관악구": 0,
    "서울 서초구": 5,
    "서울 강남구": 5,
    "서울 송파구": 4,
    "서울 강동구": 2,
    "부산": 0,
    "부산 중구": 1,
    "부산 서구": 0,
    "부산 동구": 0,
    "부산 영도구": 0,
    "부산 부산진구": 2,
    "부산 동래구": 4,
    "부산 남구": 1,
    "부산 북구": 1,
    "부산 해운대구": 2,
    "부산 사하구": 1,
    "부산 금정구": 1,
    "부산 강서구": 2,
    "부산 연제구": 0,
    "부산 수영구": 1,
    "부산 사상구": 1,
    "부산 기장군": 3,
    "대구": 0,
    "대구 중구": 0,
    "대구 동구": 2,
    "대구 서구": 2,
    "대구 남구": 1,
    "대구 북구": 0,
    "대구 수성구": 3,
    "대구 달서구": 2,
    "대구 달성군": 3,
    "대구 군위군": 0,
    "인천": 0,
    "인천 중구": 4,
    "인천 동구": 0,
    "인천 미추홀구": 0,
    "인천 연수구": 1,
    "인천 남동구": 2,
    "인천 부평구": 1,
    "인천 계양구": 0,
    "인천 서구": 5,
    "인천 강화군": 0,
    "인천 옹진군": 0,
    "광주": 0,
    "광주 동구": 0,
    "광주 서구": 0,
    "광주 남구": 1,
    "광주 북구": 0,
    "광주 광산구": 2,
    "대전": 0,
    "대전 동구": 0,
    "대전 중구": 3,
    "대전 서구": 1,
    "대전 유성구": 3,
    "대전 대덕구": 2,
    "울산": 0,
    "울산 중구": 0,
    "울산 남구": 4,
    "울산 동구": 0,
    "울산 북구": 1,
    "울산 울주군": 1,
    "세종": 0,
    "세종 반곡동": 0,
    "세종 소담동": 0,
    "세종 보람동": 0,
    "세종 대평동": 0,
    "세종 가람동": 0,
    "세종 한솔동": 0,
    "세종 나성동": 0,
    "세종 새롬동": 0,
    "세종 다정동": 0,
    "세종 어진동": 0,
    "세종 종촌동": 0,
    "세종 고운동": 0,
    "세종 아름동": 0,
    "세종 도담동": 0,
    "세종 산울동": 0,
    "세종 해밀동": 0,
    "세종 합강동": 0,
    "세종 집현동": 0,
    "세종 세종동": 0,
    "세종 누리동": 0,
    "세종 한별동": 0,
    "세종 다솜동": 0,
    "세종 용호동": 0,
    "세종 조치원읍": 0,
    "세종 연기면": 0,
    "세종 연동면": 0,
    "세종 부강면": 0,
    "세종 금남면": 0,
    "세종 장군면": 0,
    "세종 연서면": 0,
    "세종 전의면": 0,
    "세종 전동면": 0,
    "세종 소정면": 0,
    "경기": 0,
    "경기 수원시": 0,
    "경기 성남시": 0,
    "경기 의정부시": 0,
    "경기 안양시": 0,
    "경기 부천시": 0,
    "경기 광명시": 1,
    "경기 평택시": 2,
    "경기 동두천시": 0,
    "경기 안산시": 0,
    "경기 고양시": 0,
    "경기 과천시": 1,
    "경기 구리시": 2,
    "경기 남양주시": 4,
    "경기 오산시": 2,
    "경기 시흥시": 2,
    "경기 군포시": 0,
    "경기 의왕시": 0,
    "경기 하남시": 1,
    "경기 용인시": 0,
    "경기 파주시": 6,
    "경기 이천시": 3,
    "경기 안성시": 3,
    "경기 김포시": 1,
    "경기 화성시": 2,
    "경기 광주시": 3,
    "경기 양주시": 3,
    "경기 포천시": 0,
    "경기 여주시": 3,
    "경기 연천군": 0,
    "경기 가평군": 3,
    "경기 양평군": 1,
    "충북": 0,
    "충북 청주시": 0,
    "충북 충주시": 0,
    "충북 제천시": 1,
    "충북 보은군": 0,
    "충북 옥천군": 0,
    "충북 영동군": 0,
    "충북 증평군": 0,
    "충북 진천군": 0,
    "충북 괴산군": 0,
    "충북 음성군": 2,
    "충북 단양군": 0,
    "충남": 0,
    "충남 천안시": 0,
    "충남 공주시": 0,
    "충남 보령시": 1,
    "충남 아산시": 4,
    "충남 서산시": 3,
    "충남 논산시": 2,
    "충남 계룡시": 0,
    "충남 당진시": 0,
    "충남 금산군": 0,
    "충남 부여군": 0,
    "충남 서천군": 0,
    "충남 청양군": 0,
    "충남 홍성군": 0,
    "충남 예산군": 0,
    "충남 태안군": 0,
    "전남": 0,
    "전남 목포시": 1,
    "전남 여수시": 0,
    "전남 순천시": 2,
    "전남 나주시": 0,
    "전남 광양시": 2,
    "전남 담양군": 0,
    "전남 곡성군": 0,
    "전남 구례군": 0,
    "전남 고흥군": 0,
    "전남 보성군": 0,
    "전남 화순군": 1,
    "전남 장흥군": 0,
    "전남 강진군": 1,
    "전남 해남군": 0,
    "전남 영암군": 3,
    "전남 무안군": 2,
    "전남 함평군": 0,
    "전남 영광군": 0,
    "전남 장성군": 0,
    "전남 완도군": 1,
    "전남 진도군": 0,
    "전남 신안군": 0,
    "경북": 0,
    "경북 포항시": 0,
    "경북 경주시": 3,
    "경북 김천시": 1,
    "경북 안동시": 2,
    "경북 구미시": 0,
    "경북 영주시": 1,
    "경북 영천시": 0,
    "경북 상주시": 0,
    "경북 문경시": 0,
    "경북 경산시": 2,
    "경북 의성군": 0,
    "경북 청송군": 0,
    "경북 영양군": 0,
    "경북 영덕군": 0,
    "경북 청도군": 0,
    "경북 고령군": 0,
    "경북 성주군": 0,
    "경북 칠곡군": 0,
    "경북 예천군": 0,
    "경북 봉화군": 0,
    "경북 울진군": 0,
    "경북 울릉군": 0,
    "경남": 0,
    "경남 창원시": 0,
    "경남 진주시": 0,
    "경남 통영시": 0,
    "경남 사천시": 0,
    "경남 김해시": 2,
    "경남 밀양시": 0,
    "경남 거제시": 0,
    "경남 양산시": 2,
    "경남 의령군": 1,
    "경남 함안군": 1,
    "경남 창녕군": 0,
    "경남 고성군": 0,
    "경남 남해군": 0,
    "경남 하동군": 0,
    "경남 산청군": 0,
    "경남 함양군": 0,
    "경남 거창군": 0,
    "경남 합천군": 2,
    "제주": 0,
    "제주 제주시": 0,
    "제주 서귀포시": 0,
    "강원": 0,
    "강원 춘천시": 1,
    "강원 원주시": 4,
    "강원 강릉시": 1,
    "강원 동해시": 2,
    "강원 태백시": 3,
    "강원 속초시": 0,
    "강원 삼척시": 0,
    "강원 홍천군": 0,
    "강원 횡성군": 0,
    "강원 영월군": 2,
    "강원 평창군": 0,
    "강원 정선군": 2,
    "강원 철원군": 0,
    "강원 화천군": 0,
    "강원 양구군": 1,
    "강원 인제군": 0,
    "강원 고성군": 1,
    "강원 양양군": 0,
    "전북": 0,
    "전북 전주시": 0,
    "전북 군산시": 0,
    "전북 익산시": 10,
    "전북 정읍시": 1,
    "전북 남원시": 1,
    "전북 김제시": 0,
    "전북 완주군": 2,
    "전북 진안군": 1,
    "전북 무주군": 0,
    "전북 장수군": 2,
    "전북 임실군": 0,
    "전북 순창군": 0,
    "전북 고창군": 0,
    "전북 부안군": 0
}